NO ./assets/crate.xpm
SO ./assets/crate_2.xpm

F ./assets/floor.xpm
WE ./assets/tech.xpm
EA ./assets/tech_2.xpm
C ./assets/grid.xpm

        1111111111111111111111111
        1000000000110000000000001
        1011000001110000000000001
        1001000000000000000000001
1111111110111D1111110000000000001
100000000011000001110111111111111  
111101111111110011000000100011111111
1111D1111111110011010100100011111111
110000001101010011000000D00011111111
110000000000000111000000100011111111
1000000000000011 1010100101011111111
1100N00111010101 1101111000111111111
11110111 1110101 10111101F1111111111
11111111 1111111 1111111111111111111
